12
14
############
# D # b    #
#   # #  @ #
#   #      #
## ###     #
#  ###     #
# ######   #
# ####     #
# ####     #
# ####     #
#  #####   #
#   P      #
##  #      #
############