12
5
############
#   # b    #
#D  P    @ #
#   #      #
############